{
  "width": 9,
  "height": 9,
  "blocks": [[0, 2, 0, 0, 0, 0, 0, 2, 0],
            [0, 2, 0, 2, 0, 2, 0, 2, 0],
            [0, 2, 0, 2, 0, 2, 0, 2, 0],
            [0, 0, 0, 2, 0, 2, 0, 0, 0],
            [2, 2, 0, 2, 0, 2, 0, 2, 2],
            [0, 0, 0, 2, 0, 2, 0, 0, 0],
            [0, 2, 0, 2, 0, 2, 0, 2, 0],
            [0, 2, 0, 2, 0, 2, 0, 2, 0],
            [0, 2, 0, 0, 0, 0, 0, 2, 0]],
  "tanks": [[0.5, 0.5, 0], [8.5, 0.5, 0], [0.5, 8.5, 180], [8.5, 8.5, 180]],
  "flag": [4.5,4.5]
}
